0 0 0 4 3 3 3 4 0 0 0 4 3 3 3 4 0 0 0 4 3 3 3 4 0 0 0 4 3 3 3 4 0 0 0 4 3 3 3 4 0 0 0
0 0 0 4 2 2 2 4 0 0 0 4 2 2 2 4 0 0 0 4 2 4 2 4 0 0 0 4 2 2 2 4 0 0 0 4 2 2 2 4 0 0 0
0 0 0 4 1 1 1 4 3 3 3 4 1 1 1 4 3 3 3 4 1 1 1 4 3 3 3 4 1 1 1 4 3 3 3 4 1 1 1 4 0 0 0
0 0 0 4 1 1 1 1 1 1 1 1 1 1 1 1 1 1 1 1 1 1 1 1 1 1 1 1 1 1 1 1 1 1 1 1 1 1 1 4 0 0 0
0 0 0 4 1 1 1 4 4 4 4 4 1 1 1 4 4 4 4 4 1 1 1 4 4 4 4 4 1 1 1 4 4 4 4 4 1 1 1 4 0 0 0
0 0 0 4 1 1 1 4 0 0 0 4 1 1 1 4 0 0 0 4 1 1 1 4 0 0 0 4 1 1 1 4 0 0 0 4 1 1 1 4 0 0 0
0 0 0 4 4 4 1 4 4 4 4 4 4 4 1 4 4 4 4 4 4 4 1 4 4 4 4 4 4 4 1 4 4 4 4 4 4 4 1 4 0 0 0
0 0 0 0 0 4 1 4 0 0 0 0 0 4 1 4 0 0 0 0 0 4 1 4 0 0 0 0 0 4 1 4 0 0 0 0 0 4 1 4 0 0 0
0 0 0 0 0 4 1 4 0 0 0 0 0 4 1 4 0 0 0 0 0 4 1 4 0 0 0 0 0 4 1 4 0 0 0 0 0 4 1 4 0 0 0
0 0 0 0 0 4 1 4 0 0 0 0 0 4 1 4 0 0 0 0 0 4 1 4 0 0 0 0 0 4 1 4 0 0 0 0 0 4 1 4 0 0 0
0 0 0 4 3 4 1 4 3 3 3 4 3 4 1 4 3 3 3 4 3 4 1 4 3 3 3 4 3 4 1 4 3 3 3 4 3 4 1 4 3 3 3
0 0 0 4 2 2 1 2 2 2 2 4 2 2 1 2 2 2 2 4 2 2 1 2 2 2 2 4 2 2 1 2 2 2 2 4 2 2 1 2 2 2 2
0 0 0 4 1 1 1 1 1 1 1 4 1 1 1 1 1 1 1 4 1 1 1 1 1 1 1 4 1 1 1 1 1 1 1 4 1 1 1 1 1 1 1
0 0 0 4 1 1 1 1 1 1 1 4 1 1 1 1 1 1 1 4 1 1 1 1 1 1 1 4 1 1 1 1 1 1 1 4 1 1 1 1 1 1 1
0 0 0 4 1 1 1 1 1 1 1 4 1 1 1 1 1 1 1 4 1 1 1 1 1 1 1 4 1 1 1 1 1 1 1 4 1 1 1 1 1 1 1
0 0 0 4 1 1 1 1 1 1 1 4 1 1 1 1 1 1 1 4 1 1 1 1 1 1 1 4 1 1 1 1 1 1 1 4 1 1 1 1 1 1 1
0 0 0 0 0 4 1 4 0 0 0 0 0 4 1 4 0 0 0 0 0 0 0 0 0 0 0 0 0 4 1 4 0 0 0 0 0 4 1 4 0 0 0
0 0 0 0 0 4 1 4 0 0 0 0 0 4 1 4 0 0 0 0 0 0 0 0 0 0 0 0 0 4 1 4 0 0 0 0 0 4 1 4 0 0 0
0 0 0 0 0 4 1 4 0 0 0 0 0 4 1 4 0 0 0 0 0 0 0 0 0 0 0 0 0 4 1 4 0 0 0 0 0 4 1 4 0 0 0
0 0 0 4 3 4 1 4 3 3 3 4 3 4 1 4 3 3 3 4 3 3 3 3 3 3 3 4 3 4 1 4 3 3 3 4 3 4 1 4 3 3 3
0 0 0 4 2 2 1 2 2 2 2 4 2 2 1 2 2 2 2 4 2 2 2 2 2 2 2 4 2 2 1 2 2 2 2 4 2 2 1 2 2 2 2
0 0 0 4 1 1 1 1 1 1 1 4 1 1 1 1 1 1 1 4 1 1 1 1 1 1 1 4 1 1 1 1 1 1 1 4 1 1 1 1 1 1 1
0 0 0 4 1 1 1 1 1 1 1 4 1 1 1 1 1 1 1 4 1 1 1 1 1 1 1 4 1 1 1 1 1 1 1 4 1 1 1 1 1 1 1
0 0 0 4 1 1 1 1 1 1 1 4 1 1 1 1 1 1 1 4 1 1 1 1 1 1 1 4 1 1 1 1 1 1 1 4 1 1 1 1 1 1 1
0 0 0 4 1 1 1 1 1 1 1 4 1 1 1 1 1 1 1 4 1 1 1 1 1 1 1 4 1 1 1 1 1 1 1 4 1 1 1 1 1 1 1
0 0 0 4 4 4 1 4 4 4 4 4 4 4 1 4 4 4 4 4 4 4 1 4 4 4 4 4 4 4 1 4 4 4 4 4 4 4 1 4 4 4 4
0 0 0 0 0 4 1 4 0 0 0 0 0 4 1 4 0 0 0 0 0 4 1 4 0 0 0 0 0 4 1 4 0 0 0 0 0 4 1 4 0 0 0
0 0 0 0 0 4 1 4 0 0 0 0 0 4 1 4 0 0 0 0 0 4 1 4 0 0 0 0 0 4 1 4 0 0 0 0 0 4 1 4 0 0 0
0 0 0 0 0 4 1 4 0 0 0 0 0 4 1 4 0 0 0 0 0 4 1 4 0 0 0 0 0 4 1 4 0 0 0 0 0 4 1 4 0 0 0
0 0 0 4 3 4 1 4 3 3 3 4 3 4 1 4 3 3 3 4 3 4 1 4 3 3 3 4 3 4 1 4 3 3 3 4 3 4 1 4 3 3 3
0 0 0 4 2 2 1 2 2 2 2 4 2 2 1 2 2 2 2 4 2 2 1 2 2 2 2 4 2 2 1 2 2 2 2 4 2 2 1 2 2 2 2
0 0 0 4 1 1 1 1 1 1 1 4 1 1 1 1 1 1 1 4 1 1 1 1 1 1 1 4 1 1 1 1 1 1 1 4 1 1 1 1 1 1 1
0 0 0 4 1 1 1 1 1 1 1 4 1 1 1 1 1 1 1 4 1 1 1 1 1 1 1 4 1 1 1 1 1 1 1 4 1 1 1 1 1 1 1
0 0 0 4 1 1 1 1 1 1 1 4 1 1 1 1 1 1 1 4 1 1 1 1 1 1 1 4 1 1 1 1 1 1 1 4 1 1 1 1 1 1 1
0 0 0 4 1 1 1 1 1 1 1 4 1 1 1 1 1 1 1 4 1 1 1 1 1 1 1 4 1 1 1 1 1 1 1 4 1 1 1 1 1 1 1
0 0 0 4 4 4 4 4 4 4 4 4 4 4 4 4 4 4 4 4 4 4 1 4 4 4 4 4 4 4 4 4 4 4 4 4 4 4 4 4 4 4 4
0 0 0 0 0 0 0 0 0 0 0 0 0 0 0 0 0 0 0 0 0 4 1 4 0 0 0 0 0 0 0 0 0 0 0 0 0 0 0 0 0 0 0
0 0 0 0 0 0 0 0 0 0 0 0 0 0 0 0 0 0 0 0 0 4 1 4 0 0 0 0 0 0 0 0 0 0 0 0 0 0 0 0 0 0 0
0 0 0 0 0 0 0 0 0 0 0 0 0 0 0 0 0 0 0 0 0 4 1 4 0 0 0 0 0 0 0 0 0 0 0 0 0 0 0 0 0 0 0
0 0 0 0 0 0 0 0 0 0 0 0 0 0 0 0 0 0 0 4 3 4 1 4 3 3 4 0 0 0 0 0 0 0 0 0 0 0 0 0 0 0 0
0 0 0 0 0 0 0 0 0 0 0 0 0 0 0 0 0 0 0 4 2 2 1 2 2 2 4 0 0 0 0 0 0 0 0 0 0 0 0 0 0 0 0
0 0 0 0 0 0 0 0 0 0 0 0 0 0 0 0 0 0 0 4 1 1 1 1 1 1 4 0 0 0 0 0 0 0 0 0 0 0 0 0 0 0 0
0 0 0 0 0 0 0 0 0 0 0 0 0 0 0 0 0 0 0 4 1 1 1 1 1 1 4 0 0 0 0 0 0 0 0 0 0 0 0 0 0 0 0
0 0 0 0 0 0 0 0 0 0 0 0 0 0 0 0 0 0 0 4 1 1 1 1 1 1 4 0 0 0 0 0 0 0 0 0 0 0 0 0 0 0 0
0 0 0 0 0 0 0 0 0 0 0 0 0 0 0 0 0 0 0 4 4 4 4 4 4 4 4 0 0 0 0 0 0 0 0 0 0 0 0 0 0 0 0
